{
  "meta": {
    "name": "The Archives of Eternal Paperwork",
    "theme": "bureaucratic_crypt",
    "difficulty": "normal",
    "boss": "Director Mortis the Unprocessed"
  },

  "size": {
    "width": 30,
    "height": 30
  },

  "layers": [
    [
      ["  ", "  ", "  ", "  ", "  ", "  ", "  ", "  ", "  ", "  ", "  ", "  ", "F2", "F1", "F3", "F0", "F2", "F1", "  ", "  ", "  ", "  ", "  ", "  ", "  ", "  ", "  ", "  ", "  ", "  "],
      ["  ", "  ", "  ", "  ", "  ", "  ", "  ", "  ", "  ", "  ", "  ", "F3", "F0", "F2", "F1", "F3", "F0", "F2", "F1", "  ", "  ", "  ", "  ", "  ", "  ", "  ", "  ", "  ", "  ", "  "],
      ["  ", "  ", "  ", "  ", "  ", "  ", "  ", "  ", "  ", "  ", "  ", "F1", "F3", "F0", "F2", "F1", "F3", "F0", "F2", "  ", "  ", "  ", "  ", "  ", "  ", "  ", "  ", "  ", "  ", "  "],
      ["  ", "  ", "  ", "  ", "  ", "  ", "  ", "  ", "  ", "  ", "  ", "F0", "F2", "F1", "F3", "F0", "F2", "F1", "F3", "  ", "  ", "  ", "  ", "  ", "  ", "  ", "  ", "  ", "  ", "  "],
      ["  ", "  ", "  ", "  ", "  ", "  ", "  ", "  ", "  ", "  ", "  ", "F2", "F1", "F3", "F0", "F2", "F1", "F3", "F0", "  ", "  ", "  ", "  ", "  ", "  ", "  ", "  ", "  ", "  ", "  "],
      ["  ", "  ", "  ", "  ", "  ", "  ", "  ", "  ", "  ", "  ", "  ", "F3", "F0", "F2", "F1", "F3", "F0", "F2", "F1", "  ", "  ", "  ", "  ", "  ", "  ", "  ", "  ", "  ", "  ", "  "],
      ["  ", "  ", "  ", "  ", "  ", "  ", "  ", "  ", "  ", "  ", "  ", "  ", "F1", "F3", "F0", "F2", "F1", "F3", "  ", "  ", "  ", "  ", "  ", "  ", "  ", "  ", "  ", "  ", "  ", "  "],
      ["  ", "  ", "  ", "  ", "  ", "  ", "  ", "  ", "  ", "  ", "  ", "  ", "  ", "  ", "  ", "F0", "  ", "  ", "  ", "  ", "  ", "  ", "  ", "  ", "  ", "  ", "  ", "  ", "  ", "  "],
      ["  ", "  ", "  ", "  ", "  ", "  ", "  ", "  ", "  ", "  ", "  ", "  ", "  ", "  ", "  ", "F3", "  ", "  ", "  ", "  ", "  ", "  ", "  ", "  ", "  ", "  ", "  ", "  ", "  ", "  "],
      ["  ", "  ", "  ", "  ", "  ", "  ", "  ", "  ", "  ", "  ", "  ", "  ", "  ", "  ", "  ", "F1", "  ", "  ", "  ", "  ", "  ", "  ", "  ", "  ", "  ", "  ", "  ", "  ", "  ", "  "],
      ["  ", "F2", "F0", "F3", "F1", "  ", "  ", "  ", "  ", "  ", "F3", "F1", "F2", "F0", "F3", "F2", "F0", "F1", "F3", "F2", "F0", "  ", "  ", "  ", "  ", "  ", "F1", "F3", "F0", "  "],
      ["F0", "F3", "F1", "F2", "F0", "F3", "  ", "  ", "  ", "F2", "F0", "F3", "F1", "F2", "F0", "F3", "F1", "F2", "F0", "F3", "F1", "F2", "  ", "  ", "  ", "F0", "F2", "F1", "F3", "F0"],
      ["F1", "F2", "F0", "F3", "F1", "F2", "  ", "  ", "  ", "F1", "F3", "F0", "F2", "F1", "F3", "F0", "F2", "F1", "F3", "F0", "F2", "F1", "  ", "  ", "  ", "F3", "F1", "F0", "F2", "F3"],
      ["F3", "F0", "F2", "F1", "F3", "F0", "F2", "F1", "F3", "F0", "F2", "F1", "F3", "F0", "F2", "F1", "F3", "F0", "F2", "F1", "F3", "F0", "F2", "F1", "F3", "F0", "F2", "F1", "F3", "F0"],
      ["F2", "F1", "F3", "F0", "F2", "F1", "  ", "  ", "  ", "F3", "F1", "F2", "F0", "F3", "F1", "F2", "F0", "F3", "F1", "F2", "F0", "F3", "  ", "  ", "  ", "F1", "F3", "F2", "F0", "F1"],
      ["F1", "F3", "F0", "F2", "F1", "F3", "  ", "  ", "  ", "F0", "F2", "F3", "F1", "F0", "F2", "F3", "F1", "F0", "F2", "F3", "F1", "F0", "  ", "  ", "  ", "F2", "F0", "F3", "F1", "F2"],
      ["  ", "F0", "F2", "F1", "F3", "  ", "  ", "  ", "  ", "  ", "F1", "F0", "F2", "F3", "F1", "F0", "F2", "F3", "F1", "F0", "F2", "  ", "  ", "  ", "  ", "  ", "F3", "F1", "F0", "  "],
      ["  ", "  ", "  ", "  ", "  ", "  ", "  ", "  ", "  ", "  ", "  ", "  ", "  ", "  ", "  ", "F2", "  ", "  ", "  ", "  ", "  ", "  ", "  ", "  ", "  ", "  ", "  ", "  ", "  ", "  "],
      ["  ", "  ", "  ", "  ", "  ", "  ", "  ", "  ", "  ", "  ", "  ", "  ", "  ", "  ", "  ", "F1", "  ", "  ", "  ", "  ", "  ", "  ", "  ", "  ", "  ", "  ", "  ", "  ", "  ", "  "],
      ["  ", "  ", "  ", "  ", "  ", "  ", "  ", "  ", "  ", "  ", "  ", "  ", "  ", "  ", "  ", "F3", "  ", "  ", "  ", "  ", "  ", "  ", "  ", "  ", "  ", "  ", "  ", "  ", "  ", "  "],
      ["  ", "  ", "  ", "  ", "  ", "  ", "  ", "  ", "  ", "  ", "  ", "F0", "F2", "F1", "F3", "F0", "F2", "F1", "F3", "F0", "  ", "  ", "  ", "  ", "  ", "  ", "  ", "  ", "  ", "  "],
      ["  ", "  ", "  ", "  ", "  ", "  ", "  ", "  ", "  ", "  ", "F3", "F1", "F3", "F0", "F2", "F1", "F3", "F0", "F2", "F1", "F3", "  ", "  ", "  ", "  ", "  ", "  ", "  ", "  ", "  "],
      ["  ", "  ", "  ", "  ", "  ", "  ", "  ", "  ", "  ", "  ", "F2", "F0", "F2", "F1", "F3", "F0", "F2", "F1", "F3", "F0", "F2", "  ", "  ", "  ", "  ", "  ", "  ", "  ", "  ", "  "],
      ["  ", "  ", "  ", "  ", "  ", "  ", "  ", "  ", "  ", "  ", "F1", "F3", "F0", "F2", "F1", "F3", "F0", "F2", "F1", "F3", "F0", "  ", "  ", "  ", "  ", "  ", "  ", "  ", "  ", "  "],
      ["  ", "  ", "  ", "  ", "  ", "  ", "  ", "  ", "  ", "  ", "F0", "F2", "F1", "F3", "F0", "F2", "F1", "F3", "F0", "F2", "F1", "  ", "  ", "  ", "  ", "  ", "F2", "F0", "F3", "  "],
      ["  ", "  ", "  ", "  ", "  ", "  ", "  ", "  ", "  ", "  ", "F3", "F1", "F0", "F2", "F3", "F1", "F0", "F2", "F3", "F1", "F0", "F2", "F3", "F1", "F0", "F2", "F1", "F3", "F0", "F2"],
      ["  ", "  ", "  ", "  ", "  ", "  ", "  ", "  ", "  ", "  ", "F2", "F0", "F3", "F1", "F2", "F0", "F3", "F1", "F2", "F0", "F3", "  ", "  ", "  ", "  ", "F3", "F0", "F2", "F1", "F3"],
      ["  ", "  ", "  ", "  ", "  ", "  ", "  ", "  ", "  ", "  ", "F1", "F3", "F2", "F0", "F1", "F3", "F2", "F0", "F1", "F3", "F2", "  ", "  ", "  ", "  ", "F0", "F2", "F1", "F3", "F0"],
      ["  ", "  ", "  ", "  ", "  ", "  ", "  ", "  ", "  ", "  ", "F0", "F2", "F1", "F3", "F0", "F2", "F1", "F3", "F0", "F2", "F1", "  ", "  ", "  ", "  ", "F1", "F3", "F0", "F2", "F1"],
      ["  ", "  ", "  ", "  ", "  ", "  ", "  ", "  ", "  ", "  ", "  ", "F3", "F0", "F2", "F1", "F3", "F0", "F2", "F1", "F3", "  ", "  ", "  ", "  ", "  ", "  ", "F2", "F1", "F3", "  "]
    ],
    [
      ["  ", "  ", "  ", "  ", "  ", "  ", "  ", "  ", "  ", "  ", "  ", "C0", "W0", "W0", "W0", "W0", "W0", "W0", "C1", "  ", "  ", "  ", "  ", "  ", "  ", "  ", "  ", "  ", "  ", "  "],
      ["  ", "  ", "  ", "  ", "  ", "  ", "  ", "  ", "  ", "  ", "  ", "W3", "  ", "  ", "  ", "  ", "  ", "  ", "W1", "  ", "  ", "  ", "  ", "  ", "  ", "  ", "  ", "  ", "  ", "  "],
      ["  ", "  ", "  ", "  ", "  ", "  ", "  ", "  ", "  ", "  ", "  ", "W3", "  ", "  ", "  ", "  ", "  ", "  ", "W1", "  ", "  ", "  ", "  ", "  ", "  ", "  ", "  ", "  ", "  ", "  "],
      ["  ", "  ", "  ", "  ", "  ", "  ", "  ", "  ", "  ", "  ", "  ", "W3", "  ", "  ", "  ", "  ", "  ", "  ", "W1", "  ", "  ", "  ", "  ", "  ", "  ", "  ", "  ", "  ", "  ", "  "],
      ["  ", "  ", "  ", "  ", "  ", "  ", "  ", "  ", "  ", "  ", "  ", "W3", "  ", "  ", "  ", "  ", "  ", "  ", "W1", "  ", "  ", "  ", "  ", "  ", "  ", "  ", "  ", "  ", "  ", "  "],
      ["  ", "  ", "  ", "  ", "  ", "  ", "  ", "  ", "  ", "  ", "  ", "W3", "  ", "  ", "  ", "  ", "  ", "  ", "W1", "  ", "  ", "  ", "  ", "  ", "  ", "  ", "  ", "  ", "  ", "  "],
      ["  ", "  ", "  ", "  ", "  ", "  ", "  ", "  ", "  ", "  ", "  ", "C3", "W2", "W2", "W2", "G2", "W2", "W2", "C2", "  ", "  ", "  ", "  ", "  ", "  ", "  ", "  ", "  ", "  ", "  "],
      ["  ", "  ", "  ", "  ", "  ", "  ", "  ", "  ", "  ", "  ", "  ", "  ", "  ", "  ", "  ", "R1", "  ", "  ", "  ", "  ", "  ", "  ", "  ", "  ", "  ", "  ", "  ", "  ", "  ", "  "],
      ["  ", "  ", "  ", "  ", "  ", "  ", "  ", "  ", "  ", "  ", "  ", "  ", "  ", "  ", "  ", "R1", "  ", "  ", "  ", "  ", "  ", "  ", "  ", "  ", "  ", "  ", "  ", "  ", "  ", "  "],
      ["  ", "  ", "  ", "  ", "  ", "  ", "  ", "  ", "  ", "  ", "  ", "  ", "  ", "  ", "  ", "R1", "  ", "  ", "  ", "  ", "  ", "  ", "  ", "  ", "  ", "  ", "  ", "  ", "  ", "  "],
      ["C0", "W0", "W0", "W0", "W0", "C1", "  ", "  ", "  ", "C0", "W0", "W0", "W0", "W0", "W0", "G0", "W0", "W0", "W0", "W0", "W0", "C1", "  ", "  ", "  ", "C0", "W0", "W0", "W0", "C1"],
      ["W3", "  ", "  ", "  ", "  ", "W1", "  ", "  ", "  ", "W3", "  ", "  ", "  ", "  ", "  ", "  ", "  ", "  ", "  ", "  ", "  ", "W1", "  ", "  ", "  ", "W3", "  ", "  ", "  ", "W1"],
      ["W3", "  ", "  ", "  ", "  ", "W1", "  ", "  ", "  ", "W3", "  ", "  ", "  ", "  ", "  ", "  ", "  ", "  ", "  ", "  ", "  ", "W1", "  ", "  ", "  ", "W3", "  ", "  ", "  ", "W1"],
      ["W3", "  ", "  ", "  ", "  ", "G1", "R0", "R0", "R0", "G3", "  ", "  ", "  ", "  ", "  ", "  ", "  ", "  ", "  ", "  ", "  ", "G1", "R0", "R0", "R0", "G3", "  ", "  ", "  ", "W1"],
      ["W3", "  ", "  ", "  ", "  ", "W1", "  ", "  ", "  ", "W3", "  ", "  ", "  ", "  ", "  ", "  ", "  ", "  ", "  ", "  ", "  ", "W1", "  ", "  ", "  ", "W3", "  ", "  ", "  ", "W1"],
      ["W3", "  ", "  ", "  ", "  ", "W1", "  ", "  ", "  ", "W3", "  ", "  ", "  ", "  ", "  ", "  ", "  ", "  ", "  ", "  ", "  ", "W1", "  ", "  ", "  ", "W3", "  ", "  ", "  ", "W1"],
      ["C3", "W2", "W2", "W2", "W2", "C2", "  ", "  ", "  ", "C3", "W2", "W2", "W2", "W2", "W2", "G2", "W2", "W2", "W2", "W2", "W2", "C2", "  ", "  ", "  ", "C3", "W2", "W2", "W2", "C2"],
      ["  ", "  ", "  ", "  ", "  ", "  ", "  ", "  ", "  ", "  ", "  ", "  ", "  ", "  ", "  ", "R1", "  ", "  ", "  ", "  ", "  ", "  ", "  ", "  ", "  ", "  ", "  ", "  ", "  ", "  "],
      ["  ", "  ", "  ", "  ", "  ", "  ", "  ", "  ", "  ", "  ", "  ", "  ", "  ", "  ", "  ", "R1", "  ", "  ", "  ", "  ", "  ", "  ", "  ", "  ", "  ", "  ", "  ", "  ", "  ", "  "],
      ["  ", "  ", "  ", "  ", "  ", "  ", "  ", "  ", "  ", "  ", "  ", "  ", "  ", "  ", "  ", "R1", "  ", "  ", "  ", "  ", "  ", "  ", "  ", "  ", "  ", "  ", "  ", "  ", "  ", "  "],
      ["  ", "  ", "  ", "  ", "  ", "  ", "  ", "  ", "  ", "  ", "C0", "W0", "W0", "W0", "W0", "G0", "W0", "W0", "W0", "W0", "C1", "  ", "  ", "  ", "  ", "  ", "  ", "  ", "  ", "  "],
      ["  ", "  ", "  ", "  ", "  ", "  ", "  ", "  ", "  ", "  ", "W3", "  ", "  ", "  ", "  ", "  ", "  ", "  ", "  ", "  ", "W1", "  ", "  ", "  ", "  ", "  ", "  ", "  ", "  ", "  "],
      ["  ", "  ", "  ", "  ", "  ", "  ", "  ", "  ", "  ", "  ", "W3", "  ", "  ", "  ", "  ", "  ", "  ", "  ", "  ", "  ", "W1", "  ", "  ", "  ", "  ", "  ", "  ", "  ", "  ", "  "],
      ["  ", "  ", "  ", "  ", "  ", "  ", "  ", "  ", "  ", "  ", "W3", "  ", "  ", "  ", "  ", "  ", "  ", "  ", "  ", "  ", "W1", "  ", "  ", "  ", "  ", "  ", "  ", "  ", "  ", "  "],
      ["  ", "  ", "  ", "  ", "  ", "  ", "  ", "  ", "  ", "  ", "W3", "  ", "  ", "  ", "  ", "  ", "  ", "  ", "  ", "  ", "W1", "  ", "  ", "  ", "  ", "C0", "W0", "W0", "W0", "C1"],
      ["  ", "  ", "  ", "  ", "  ", "  ", "  ", "  ", "  ", "  ", "W3", "  ", "  ", "  ", "  ", "  ", "  ", "  ", "  ", "  ", "G1", "R0", "R0", "R0", "R0", "G3", "  ", "  ", "  ", "W1"],
      ["  ", "  ", "  ", "  ", "  ", "  ", "  ", "  ", "  ", "  ", "W3", "  ", "  ", "  ", "  ", "  ", "  ", "  ", "  ", "  ", "W1", "  ", "  ", "  ", "  ", "W3", "  ", "  ", "  ", "W1"],
      ["  ", "  ", "  ", "  ", "  ", "  ", "  ", "  ", "  ", "  ", "W3", "  ", "  ", "  ", "  ", "  ", "  ", "  ", "  ", "  ", "W1", "  ", "  ", "  ", "  ", "W3", "  ", "  ", "  ", "W1"],
      ["  ", "  ", "  ", "  ", "  ", "  ", "  ", "  ", "  ", "  ", "W3", "  ", "  ", "  ", "  ", "  ", "  ", "  ", "  ", "  ", "W1", "  ", "  ", "  ", "  ", "W3", "  ", "  ", "  ", "W1"],
      ["  ", "  ", "  ", "  ", "  ", "  ", "  ", "  ", "  ", "  ", "C3", "W2", "W2", "W2", "W2", "W2", "W2", "W2", "W2", "W2", "C2", "  ", "  ", "  ", "  ", "C3", "W2", "W2", "W2", "C2"]
    ]
  ],

  "lights": [
    [15, 3, "#ff6644", 0.5, 20],
    [15, 13, "#aa88ff", 0.45, 25],
    [3, 13, "#ffcc66", 0.4, 15],
    [27, 13, "#66ffaa", 0.4, 15],
    [15, 25, "#ffeecc", 0.4, 22],
    [27, 27, "#66aaff", 0.4, 14]
  ],

  "rooms": [
    ["Sanctum of Final Audit", 11, 0, 8, 7, "boss"],
    ["The Great Filing Hall", 9, 10, 13, 7, "arena"],
    ["Petty Cash Vault", 0, 10, 6, 7, "treasure"],
    ["Supply Closet of Holding", 25, 10, 5, 7, "treasure"],
    ["Hall of First Impressions", 10, 20, 11, 10, "arena"],
    ["Records Annex", 25, 24, 5, 6, "secret"]
  ]
}
