{
  "size": {
    "width": 30,
    "height": 28
  },

  "layers": [
    [
      ["  ", "  ", "  ", "  ", "  ", "  ", "  ", "  ", "  ", "  ", "  ", "  ", "  ", "  ", "F2", "F3", "F0", "  ", "  ", "  ", "  ", "  ", "  ", "  ", "  ", "  ", "  ", "  ", "  ", "  "],
      ["  ", "  ", "  ", "  ", "  ", "  ", "  ", "  ", "  ", "  ", "  ", "  ", "  ", "F2", "F3", "F0", "F1", "F2", "  ", "  ", "  ", "  ", "  ", "  ", "  ", "  ", "  ", "  ", "  ", "  "],
      ["  ", "  ", "  ", "  ", "  ", "  ", "  ", "  ", "  ", "  ", "  ", "  ", "  ", "F3", "F0", "F1", "F2", "F3", "  ", "  ", "  ", "  ", "  ", "  ", "  ", "  ", "  ", "  ", "  ", "  "],
      ["  ", "  ", "  ", "  ", "  ", "  ", "  ", "  ", "  ", "  ", "  ", "  ", "  ", "F0", "F1", "F2", "F3", "F0", "  ", "  ", "  ", "  ", "  ", "  ", "  ", "  ", "  ", "  ", "  ", "  "],
      ["  ", "  ", "  ", "  ", "  ", "  ", "  ", "  ", "  ", "  ", "  ", "  ", "  ", "  ", "F2", "F3", "F0", "  ", "  ", "  ", "  ", "  ", "  ", "  ", "  ", "  ", "  ", "  ", "  ", "  "],
      ["  ", "  ", "  ", "  ", "  ", "  ", "  ", "  ", "  ", "  ", "  ", "  ", "  ", "  ", "  ", "  ", "  ", "  ", "  ", "  ", "  ", "  ", "  ", "  ", "  ", "  ", "  ", "  ", "  ", "  "],
      ["  ", "  ", "  ", "  ", "  ", "  ", "  ", "  ", "  ", "  ", "  ", "  ", "  ", "  ", "  ", "  ", "  ", "  ", "  ", "  ", "  ", "  ", "  ", "  ", "  ", "  ", "  ", "  ", "  ", "  "],
      ["  ", "  ", "  ", "  ", "  ", "  ", "  ", "  ", "  ", "  ", "  ", "  ", "  ", "  ", "  ", "  ", "  ", "  ", "  ", "  ", "  ", "  ", "  ", "  ", "  ", "  ", "  ", "  ", "  ", "  "],
      ["  ", "F1", "F2", "F3", "F0", "  ", "  ", "  ", "  ", "  ", "F2", "F3", "F0", "F1", "F2", "F3", "F0", "F1", "F2", "F3", "F0", "  ", "  ", "  ", "  ", "  ", "F2", "F3", "F0", "  "],
      ["F1", "F2", "F3", "F0", "F1", "F2", "  ", "  ", "  ", "F2", "F3", "F0", "F1", "F2", "F3", "F0", "F1", "F2", "F3", "F0", "F1", "F2", "  ", "  ", "  ", "F2", "F3", "F0", "F1", "F2"],
      ["F2", "F3", "F0", "F1", "F2", "F3", "  ", "  ", "  ", "F3", "F0", "F1", "F2", "F3", "F0", "F1", "F2", "F3", "F0", "F1", "F2", "F3", "  ", "  ", "  ", "F3", "F0", "F1", "F2", "F3"],
      ["F3", "F0", "F1", "F2", "F3", "F0", "  ", "  ", "  ", "F0", "F1", "F2", "F3", "F0", "F1", "F2", "F3", "F0", "F1", "F2", "F3", "F0", "  ", "  ", "  ", "F0", "F1", "F2", "F3", "F0"],
      ["F0", "F1", "F2", "F3", "F0", "F1", "  ", "  ", "  ", "F1", "F2", "F3", "F0", "F1", "F2", "F3", "F0", "F1", "F2", "F3", "F0", "F1", "  ", "  ", "  ", "F1", "F2", "F3", "F0", "F1"],
      ["F1", "F2", "F3", "F0", "F1", "F2", "  ", "  ", "  ", "F2", "F3", "F0", "F1", "F2", "F3", "F0", "F1", "F2", "F3", "F0", "F1", "F2", "  ", "  ", "  ", "F2", "F3", "F0", "F1", "F2"],
      ["  ", "F3", "F0", "F1", "F2", "  ", "  ", "  ", "  ", "  ", "F0", "F1", "F2", "F3", "F0", "F1", "F2", "F3", "F0", "F1", "F2", "  ", "  ", "  ", "  ", "  ", "F0", "F1", "F2", "  "],
      ["  ", "  ", "  ", "  ", "  ", "  ", "  ", "  ", "  ", "  ", "  ", "  ", "  ", "  ", "  ", "  ", "  ", "  ", "  ", "  ", "  ", "  ", "  ", "  ", "  ", "  ", "  ", "  ", "  ", "  "],
      ["  ", "  ", "  ", "  ", "  ", "  ", "  ", "  ", "  ", "  ", "  ", "  ", "  ", "  ", "  ", "  ", "  ", "  ", "  ", "  ", "  ", "  ", "  ", "  ", "  ", "  ", "  ", "  ", "  ", "  "],
      ["  ", "  ", "  ", "  ", "  ", "  ", "  ", "  ", "  ", "  ", "  ", "  ", "  ", "  ", "  ", "  ", "  ", "  ", "  ", "  ", "  ", "  ", "  ", "  ", "  ", "  ", "  ", "  ", "  ", "  "],
      ["  ", "  ", "  ", "  ", "  ", "  ", "  ", "  ", "  ", "  ", "  ", "F1", "F2", "F3", "F0", "F1", "F2", "F3", "F0", "F1", "  ", "  ", "  ", "  ", "  ", "  ", "  ", "  ", "  ", "  "],
      ["  ", "  ", "  ", "  ", "  ", "  ", "  ", "  ", "  ", "  ", "F1", "F2", "F3", "F0", "F1", "F2", "F3", "F0", "F1", "F2", "F3", "  ", "  ", "  ", "  ", "  ", "  ", "  ", "  ", "  "],
      ["  ", "  ", "  ", "  ", "  ", "  ", "  ", "  ", "  ", "  ", "F2", "F3", "F0", "F1", "F2", "F3", "F0", "F1", "F2", "F3", "F0", "  ", "  ", "  ", "  ", "  ", "  ", "  ", "  ", "  "],
      ["  ", "  ", "  ", "  ", "  ", "  ", "  ", "  ", "  ", "  ", "F3", "F0", "F1", "F2", "F3", "F0", "F1", "F2", "F3", "F0", "F1", "  ", "  ", "  ", "  ", "  ", "  ", "  ", "  ", "  "],
      ["  ", "  ", "  ", "  ", "  ", "  ", "  ", "  ", "  ", "  ", "F0", "F1", "F2", "F3", "F0", "F1", "F2", "F3", "F0", "F1", "F2", "  ", "  ", "  ", "  ", "  ", "F0", "F1", "F2", "  "],
      ["  ", "  ", "  ", "  ", "  ", "  ", "  ", "  ", "  ", "  ", "F1", "F2", "F3", "F0", "F1", "F2", "F3", "F0", "F1", "F2", "F3", "  ", "  ", "  ", "  ", "F0", "F1", "F2", "F3", "F0"],
      ["  ", "  ", "  ", "  ", "  ", "  ", "  ", "  ", "  ", "  ", "F2", "F3", "F0", "F1", "F2", "F3", "F0", "F1", "F2", "F3", "F0", "  ", "  ", "  ", "  ", "F1", "F2", "F3", "F0", "F1"],
      ["  ", "  ", "  ", "  ", "  ", "  ", "  ", "  ", "  ", "  ", "  ", "F0", "F1", "F2", "F3", "F0", "F1", "F2", "F3", "F0", "  ", "  ", "  ", "  ", "  ", "F2", "F3", "F0", "F1", "F2"],
      ["  ", "  ", "  ", "  ", "  ", "  ", "  ", "  ", "  ", "  ", "  ", "  ", "  ", "  ", "  ", "  ", "  ", "  ", "  ", "  ", "  ", "  ", "  ", "  ", "  ", "F3", "F0", "F1", "F2", "F3"],
      ["  ", "  ", "  ", "  ", "  ", "  ", "  ", "  ", "  ", "  ", "  ", "  ", "  ", "  ", "  ", "  ", "  ", "  ", "  ", "  ", "  ", "  ", "  ", "  ", "  ", "  ", "F1", "F2", "F3", "  "]
    ],
    [
      ["  ", "  ", "  ", "  ", "  ", "  ", "  ", "  ", "  ", "  ", "  ", "  ", "  ", "C0", "W0", "W0", "W0", "C1", "  ", "  ", "  ", "  ", "  ", "  ", "  ", "  ", "  ", "  ", "  ", "  "],
      ["  ", "  ", "  ", "  ", "  ", "  ", "  ", "  ", "  ", "  ", "  ", "  ", "  ", "W3", "  ", "  ", "  ", "W1", "  ", "  ", "  ", "  ", "  ", "  ", "  ", "  ", "  ", "  ", "  ", "  "],
      ["  ", "  ", "  ", "  ", "  ", "  ", "  ", "  ", "  ", "  ", "  ", "  ", "  ", "W3", "  ", "  ", "  ", "W1", "  ", "  ", "  ", "  ", "  ", "  ", "  ", "  ", "  ", "  ", "  ", "  "],
      ["  ", "  ", "  ", "  ", "  ", "  ", "  ", "  ", "  ", "  ", "  ", "  ", "  ", "W3", "  ", "  ", "  ", "W1", "  ", "  ", "  ", "  ", "  ", "  ", "  ", "  ", "  ", "  ", "  ", "  "],
      ["  ", "  ", "  ", "  ", "  ", "  ", "  ", "  ", "  ", "  ", "  ", "  ", "  ", "C3", "W2", "G2", "W2", "C2", "  ", "  ", "  ", "  ", "  ", "  ", "  ", "  ", "  ", "  ", "  ", "  "],
      ["  ", "  ", "  ", "  ", "  ", "  ", "  ", "  ", "  ", "  ", "  ", "  ", "  ", "  ", "  ", "R1", "  ", "  ", "  ", "  ", "  ", "  ", "  ", "  ", "  ", "  ", "  ", "  ", "  ", "  "],
      ["  ", "  ", "  ", "  ", "  ", "  ", "  ", "  ", "  ", "  ", "  ", "  ", "  ", "  ", "  ", "R1", "  ", "  ", "  ", "  ", "  ", "  ", "  ", "  ", "  ", "  ", "  ", "  ", "  ", "  "],
      ["  ", "  ", "  ", "  ", "  ", "  ", "  ", "  ", "  ", "  ", "  ", "  ", "  ", "  ", "  ", "R1", "  ", "  ", "  ", "  ", "  ", "  ", "  ", "  ", "  ", "  ", "  ", "  ", "  ", "  "],
      ["C0", "W0", "W0", "W0", "W0", "C1", "  ", "  ", "  ", "C0", "W0", "W0", "W0", "W0", "W0", "G0", "W0", "W0", "W0", "W0", "W0", "C1", "  ", "  ", "  ", "C0", "W0", "W0", "W0", "C1"],
      ["W3", "  ", "  ", "  ", "  ", "W1", "  ", "  ", "  ", "W3", "  ", "  ", "  ", "  ", "  ", "  ", "  ", "  ", "  ", "  ", "  ", "W1", "  ", "  ", "  ", "W3", "  ", "  ", "  ", "W1"],
      ["W3", "  ", "  ", "  ", "  ", "W1", "  ", "  ", "  ", "W3", "  ", "  ", "  ", "  ", "  ", "  ", "  ", "  ", "  ", "  ", "  ", "W1", "  ", "  ", "  ", "W3", "  ", "  ", "  ", "W1"],
      ["W3", "  ", "  ", "  ", "  ", "G1", "R0", "R0", "R0", "G3", "  ", "  ", "  ", "  ", "  ", "  ", "  ", "  ", "  ", "  ", "  ", "G1", "R0", "R0", "R0", "G3", "  ", "  ", "  ", "W1"],
      ["W3", "  ", "  ", "  ", "  ", "W1", "  ", "  ", "  ", "W3", "  ", "  ", "  ", "  ", "  ", "  ", "  ", "  ", "  ", "  ", "  ", "W1", "  ", "  ", "  ", "W3", "  ", "  ", "  ", "W1"],
      ["W3", "  ", "  ", "  ", "  ", "W1", "  ", "  ", "  ", "W3", "  ", "  ", "  ", "  ", "  ", "  ", "  ", "  ", "  ", "  ", "  ", "W1", "  ", "  ", "  ", "W3", "  ", "  ", "  ", "W1"],
      ["C3", "W2", "W2", "W2", "W2", "C2", "  ", "  ", "  ", "C3", "W2", "W2", "W2", "W2", "W2", "G2", "W2", "W2", "W2", "W2", "W2", "C2", "  ", "  ", "  ", "C3", "W2", "W2", "W2", "C2"],
      ["  ", "  ", "  ", "  ", "  ", "  ", "  ", "  ", "  ", "  ", "  ", "  ", "  ", "  ", "  ", "R1", "  ", "  ", "  ", "  ", "  ", "  ", "  ", "  ", "  ", "  ", "  ", "  ", "  ", "  "],
      ["  ", "  ", "  ", "  ", "  ", "  ", "  ", "  ", "  ", "  ", "  ", "  ", "  ", "  ", "  ", "R1", "  ", "  ", "  ", "  ", "  ", "  ", "  ", "  ", "  ", "  ", "  ", "  ", "  ", "  "],
      ["  ", "  ", "  ", "  ", "  ", "  ", "  ", "  ", "  ", "  ", "  ", "  ", "  ", "  ", "  ", "R1", "  ", "  ", "  ", "  ", "  ", "  ", "  ", "  ", "  ", "  ", "  ", "  ", "  ", "  "],
      ["  ", "  ", "  ", "  ", "  ", "  ", "  ", "  ", "  ", "  ", "C0", "W0", "W0", "W0", "W0", "G0", "W0", "W0", "W0", "W0", "C1", "  ", "  ", "  ", "  ", "  ", "  ", "  ", "  ", "  "],
      ["  ", "  ", "  ", "  ", "  ", "  ", "  ", "  ", "  ", "  ", "W3", "  ", "  ", "  ", "  ", "  ", "  ", "  ", "  ", "  ", "W1", "  ", "  ", "  ", "  ", "  ", "  ", "  ", "  ", "  "],
      ["  ", "  ", "  ", "  ", "  ", "  ", "  ", "  ", "  ", "  ", "W3", "  ", "  ", "  ", "  ", "  ", "  ", "  ", "  ", "  ", "W1", "  ", "  ", "  ", "  ", "  ", "  ", "  ", "  ", "  "],
      ["  ", "  ", "  ", "  ", "  ", "  ", "  ", "  ", "  ", "  ", "W3", "  ", "  ", "  ", "  ", "  ", "  ", "  ", "  ", "  ", "W1", "  ", "  ", "  ", "  ", "  ", "  ", "  ", "  ", "  "],
      ["  ", "  ", "  ", "  ", "  ", "  ", "  ", "  ", "  ", "  ", "W3", "  ", "  ", "  ", "  ", "  ", "  ", "  ", "  ", "  ", "W1", "  ", "  ", "  ", "  ", "C0", "W0", "W0", "W0", "C1"],
      ["  ", "  ", "  ", "  ", "  ", "  ", "  ", "  ", "  ", "  ", "W3", "  ", "  ", "  ", "  ", "  ", "  ", "  ", "  ", "  ", "G1", "R0", "R0", "R0", "R0", "G3", "  ", "  ", "  ", "W1"],
      ["  ", "  ", "  ", "  ", "  ", "  ", "  ", "  ", "  ", "  ", "W3", "  ", "  ", "  ", "  ", "  ", "  ", "  ", "  ", "  ", "W1", "  ", "  ", "  ", "  ", "W3", "  ", "  ", "  ", "W1"],
      ["  ", "  ", "  ", "  ", "  ", "  ", "  ", "  ", "  ", "  ", "C3", "W2", "W2", "W2", "W2", "W2", "W2", "W2", "W2", "W2", "C2", "  ", "  ", "  ", "  ", "W3", "  ", "  ", "  ", "W1"],
      ["  ", "  ", "  ", "  ", "  ", "  ", "  ", "  ", "  ", "  ", "  ", "  ", "  ", "  ", "  ", "  ", "  ", "  ", "  ", "  ", "  ", "  ", "  ", "  ", "  ", "W3", "  ", "  ", "  ", "W1"],
      ["  ", "  ", "  ", "  ", "  ", "  ", "  ", "  ", "  ", "  ", "  ", "  ", "  ", "  ", "  ", "  ", "  ", "  ", "  ", "  ", "  ", "  ", "  ", "  ", "  ", "C3", "W2", "W2", "W2", "C2"]
    ]
  ],

  "lights": [
    [15, 2, "#ff6644", 0.5, 20],
    [15, 11, "#aa88ff", 0.45, 25],
    [3, 11, "#ffcc66", 0.4, 15],
    [27, 11, "#66ffaa", 0.4, 15],
    [15, 21.5, "#ffeecc", 0.4, 22],
    [27, 25, "#66aaff", 0.4, 14]
  ],

  "markers": [
    {"x":15,"y":1,"type":"START","facing":"S"},
    {"x":15,"y":8,"type":"ENCOUNTER","facing":"N","enemies":[{"type":"skeleton_soldier","dx":0,"dy":0}]},
    {"x":9,"y":11,"type":"ENCOUNTER","facing":"E","enemies":[{"type":"skeleton_soldier","dx":0,"dy":0}]},
    {"x":15,"y":14,"type":"ENCOUNTER","facing":"N","enemies":[{"type":"skeleton_soldier","dx":0,"dy":0}]},
    {"x":21,"y":11,"type":"ENCOUNTER","facing":"W","enemies":[{"type":"skeleton_soldier","dx":0,"dy":0}]},
    {"x":15,"y":11,"type":"ENCOUNTER","facing":"N","enemies":[{"type":"skeleton_soldier","dx":0,"dy":0}]},
    {"x":15,"y":18,"type":"ENCOUNTER","facing":"N","enemies":[{"type":"skeleton_soldier","dx":0,"dy":0}]},
    {"x":13,"y":22,"type":"ENCOUNTER","facing":"N","enemies":[{"type":"skeleton_soldier","dx":0,"dy":0}]},
    {"x":16,"y":22,"type":"ENCOUNTER","facing":"N","enemies":[{"type":"skeleton_soldier","dx":0,"dy":0}]},
    {"x":19,"y":23,"type":"ENCOUNTER","facing":"N","enemies":[{"type":"skeleton_soldier","dx":0,"dy":0}]},
    {"x":25,"y":11,"type":"ENCOUNTER","facing":"W","enemies":[{"type":"skeleton_soldier","dx":0,"dy":0}]},
    {"x":3,"y":11,"type":"ENCOUNTER","facing":"E","enemies":[{"type":"skeleton_soldier","dx":0,"dy":0}]},
    {"x":5,"y":8,"type":"ENCOUNTER","facing":"S","enemies":[{"type":"skeleton_soldier","dx":0,"dy":0}]},
    {"x":5,"y":14,"type":"ENCOUNTER","facing":"N","enemies":[{"type":"skeleton_soldier","dx":0,"dy":0}]},
    {"x":0,"y":11,"type":"ENCOUNTER","facing":"E","enemies":[{"type":"skeleton_soldier","dx":0,"dy":0}]},
    {"x":29,"y":11,"type":"BOSS","facing":"W","enemy":{"type":"director_mortis","dx":0,"dy":0}},
    {"x":27,"y":27,"type":"BOSS","facing":"N","enemy":{"type":"director_mortis","dx":0,"dy":0}}
  ]
}
